000000000000000000000
022222222222222202220
021100000000000001120
021222222222222222120
000200000200000002020
020202220202222202020
020212121202020202020
021222222222222222120
000200000200000002020
020202220202202202020
020222220212222202020
020000000200000002000
021222222222222222120
021100000000000001120
022222222222222202220
000000000000000000000
