00000000000000000000
02222022222022220220
02210201020102010220
02122221222212222120
02020102020102020220
00212222122212222100
01020102010201020220
02221222212222122210
01020202020102020220
00122212222222122200
02020102010202020210
02222221222222212220
02010202020102020200
01222122122221222210
02020201020202010220
02122221222212222200
02020202020202120220
02221222221221222220
02220201020202020220
00000000000000000000
