11111111111111111111111111111111111
11111112121112111111112111111111111
11111211114121121111111121212111111
11212211141411111111111111111211111
11111111111124111112111111111111111
11111141111112144111111111111111111
11121111111111111441111111121111111
11211111111111111141414111121111111
11111111121111211311111441121111111
11111111211111111211111114112211111
11114112111111111111111111441111111
11111121121411111111131111144122111
11111111111111111211111111111411111
11111211111111111111141111121411111
11111111211111111112111111411441111
11111111111111111111111111121121111
11111211111211111121111112111111111
11111111111111111111111111111111111
